04000067700907=A
0400003499360D=M
04000034152104=P
04000066339800=J
04000064396509=B
04000011777806=C
04000011224807=D
0400002240850A=E
0400003707350E=F
04000037510902=G
04000037810103=H
0400003833790F=I
0400006435360C=K
0400003600500D=L
04000036609303=N
0400006596570A=O
0400006491400B=Q
0400006103860F=R
04000034813006=S
04000033851102=T
0400006814210C=U
04000019282700=V
0400006014070E=W
04000050002700=X
04000049964204=Y
04000020229306=Z

